-0.15000000000000002 -0.15000000000000002 10 10 0.1
127 127 127 127 127 127 127 127 127 127
127 -128 -128 -128 -128 -128 -128 -128 -128 127
127 -128 127 -128 -128 -128 -128 127 -128 127
127 -128 -128 127 -128 -128 -128 127 -128 127
127 -128 -128 -128 127 -128 -128 127 -128 127
127 -128 -128 -128 -128 -128 -128 127 -128 127
127 -128 -128 -128 -128 -128 -128 -128 -128 127
127 -128 127 127 -128 -128 -128 -128 -128 127
127 -128 -128 -128 -128 -128 -128 -128 -128 127
127 127 127 127 127 127 127 127 127 127
